14 18
.CCCC.B..H.H..H...| 1
..........H..H...P| 2
.P.....DD.....H..P| 3
..P..C......D....P| 4
H..P..C...D..D.S.P| 5
.H..P..C..D......P| 6
H....P..C...CCCC..| 7
..S.......C.......| 8
.........C..S.H.H.| 9
.PPPPP..C......H..| 10
.......C..D......S| 11
....D....D...DD...| 12
.H..D..D..........| 13
H.H...D..S..PPPPP.| 14
